12,12,3,1,1,1,3,1,1,1,3,0
12,12,1,0,0,0,1,0,0,0,1,0
0,0,1,0,0,0,1,0,0,0,1,0
0,0,1,0,0,0,1,0,0,0,1,0
0,0,3,1,1,1,3,0,0,0,1,0
0,0,1,0,0,0,1,0,0,0,1,0
0,0,1,0,0,0,1,0,0,0,1,0
1,1,3,0,0,0,3,1,2,1,3,0
0,0,1,0,0,0,1,0,0,0,1,0
0,0,1,0,0,0,1,0,0,0,1,0
0,0,3,1,1,1,3,0,0,0,1,0
0,0,1,0,0,0,1,0,0,0,1,0
0,0,1,0,0,0,1,0,12,12,1,0
0,0,1,0,0,0,1,0,12,4,1,0
1,1,3,1,1,1,3,1,1,1,3,0
0,0,0,0,0,0,0,0,0,0,0,0
